NO    ./images/hello.xpm
SO ./images/salut.xpm
WE     ./images/wood.xpm
EA ./images/images.xpm

F 148,148,148
C 0,0,0

11111111111111111111111111111111111111111
10000000001111111100000000000000010000001
10000000001111111100000000000000010000011
10000000000000000000000000000000000000011
100000000000000000S0000000111111111000011
10000000000000000000000000111111111000011
10000111111111000000000000111111111000011
10000111111111000000000000000000000000011
10000111111111000000000000000000000000011
10000000000000000000000000000000000000011
11111111111111111111111111111111111111111
