NO    ./images/mur7.xpm
SO ./images/mur3.xpm
WE     ./images/mur.xpm
EA ./images/mur6.xpm

F 148,148,148
C 143,167,230

111111
100101
101001
1100N1
111111