NO ./textures/mur7.xpm
SO ./textures/mur3.xpm
WE ./textures/mur.xpm
EA ./textures/mur6.xpm

F 148,148,148
C 143,167,230



   11111111111     1111111    
   10000000001     1000001    
1111000000000111111100000111111
1000000000000000000000 00000001
100000000000000000S000000011111
100000000000000000000000001
1000011111111100000011000011111
1000011111111100000011000000001
1000011111111100000000000000001
1000000000000000000000000000001
1000000000000000001111110000001
1000000000000000001    10000001
1000000000000000001    10000001
1000000011100000001    11111111  
1000000011100000001
1000000011100000001111111111111
1000000000000000000000000000001
1000000000000000000000000000001
1000000000000000011111100000001
1111111110000000011111100000001
        10000000011111100000001
        10000000000000000000001
        11111111111111111111111