NO ./textures/mur7.xpm
SO ./textures/mur3.xpm
WE ./textures/mur.xpm
EA ./textures/mur6.xpm

F 148,148,148
C 143,167,230



11111111111111111111111111111111111111111
 100000000011111111000000000000000100001
10000000001111111100000000000000100000001
10000000000000000000000000000000000000011
100000000000000000S0000000111111111000011
10000000000000000000000000111111111000011
10000111111111000000000000111111111000011
10000111111111000000000000000000000000011
10000111111111000000000000000000000000011
1000000000000000000000000000000000000001
1111111111111111111111111111111111111111
