NO ./textures/mur7.xpm
SO ./textures/mur3.xpm
WE ./textures/mur.xpm
EA ./textures/mur6.xpm

F 148,148,148
C 143,167,230



  11111111111111111111111111111111111111
  10000000111111110000000000000000000001
1110000000111111110000000000000000000001
1000000000000000000000000000000000000001
1000000000000000000000000011111111100001
1000011111111100000000000011111111100001
1000011111111100000000000011111111100001
1000000000000000000000000000000000000001
1000011111111100000000000000000000000001
100001111111110000000000S000000000000001
1000000000000000000000000000000000000001
1000000000000000000000000000000000000001
1000000000000000000000000000000000000001
1000000000000000000000000011111111100001
1000000000000000000000000011111111100001
1000011111111100000000000011111111100001
1000011111111100000000000000000000000001
1000011111111100000000000000000000000001
1000000000000000000000000000000000001111
1111111111111111111111111111111111111
